"filename", "language", "PHP", "HTML", "PostCSS", "JavaScript", "comment", "blank", "total"
"c:\xampp\htdocs\Gretex Corporate main\about\index.php", "PHP", 505, 0, 0, 0, 7, 62, 574
"c:\xampp\htdocs\Gretex Corporate main\about\our-approach.php", "PHP", 0, 0, 0, 0, 0, 1, 1
"c:\xampp\htdocs\Gretex Corporate main\admin\create-post.php", "PHP", 98, 0, 0, 0, 5, 22, 125
"c:\xampp\htdocs\Gretex Corporate main\admin\dashboard.php", "PHP", 94, 0, 0, 0, 1, 22, 117
"c:\xampp\htdocs\Gretex Corporate main\admin\db.php", "PHP", 13, 0, 0, 0, 0, 5, 18
"c:\xampp\htdocs\Gretex Corporate main\admin\delete-post.php", "PHP", 29, 0, 0, 0, 2, 6, 37
"c:\xampp\htdocs\Gretex Corporate main\admin\edit-post.php", "PHP", 102, 0, 0, 0, 7, 17, 126
"c:\xampp\htdocs\Gretex Corporate main\admin\login.php", "PHP", 18, 0, 0, 0, 1, 3, 22
"c:\xampp\htdocs\Gretex Corporate main\admin\logout.php", "PHP", 6, 0, 0, 0, 0, 1, 7
"c:\xampp\htdocs\Gretex Corporate main\blog\blog-template.php", "PHP", 206, 0, 0, 0, 0, 27, 233
"c:\xampp\htdocs\Gretex Corporate main\blog\index.php", "PHP", 246, 0, 0, 0, 0, 32, 278
"c:\xampp\htdocs\Gretex Corporate main\careers\catalyst-connect.php", "PHP", 311, 0, 0, 0, 8, 55, 374
"c:\xampp\htdocs\Gretex Corporate main\careers\index.php", "PHP", 887, 0, 0, 0, 16, 57, 960
"c:\xampp\htdocs\Gretex Corporate main\careers\job.php", "PHP", 116, 0, 0, 0, 0, 16, 132
"c:\xampp\htdocs\Gretex Corporate main\contact\index.php", "PHP", 221, 0, 0, 0, 0, 28, 249
"c:\xampp\htdocs\Gretex Corporate main\csr\index.php", "PHP", 518, 0, 0, 0, 2, 46, 566
"c:\xampp\htdocs\Gretex Corporate main\css\Ipo\a-m-febcon-limited.css", "PostCSS", 0, 0, 30, 0, 0, 3, 33
"c:\xampp\htdocs\Gretex Corporate main\css\Ipo\aaron-industries-limited.css", "PostCSS", 0, 0, 30, 0, 0, 3, 33
"c:\xampp\htdocs\Gretex Corporate main\css\Ipo\aki-india-limited.css", "PostCSS", 0, 0, 30, 0, 0, 3, 33
"c:\xampp\htdocs\Gretex Corporate main\css\Ipo\amic-forging-limited.css", "PostCSS", 0, 0, 30, 0, 0, 3, 33
"c:\xampp\htdocs\Gretex Corporate main\css\Ipo\arc-insulation-&-insulators-limited.css", "PostCSS", 0, 0, 30, 0, 0, 3, 33
"c:\xampp\htdocs\Gretex Corporate main\css\Ipo\associated-coaters-limited.css", "PostCSS", 0, 0, 30, 0, 0, 3, 33
"c:\xampp\htdocs\Gretex Corporate main\css\Ipo\b-&-b-triplewall-containers-limited.css", "PostCSS", 0, 0, 30, 0, 0, 3, 33
"c:\xampp\htdocs\Gretex Corporate main\css\Ipo\b-right-realestate-limited.css", "PostCSS", 0, 0, 30, 0, 0, 3, 33
"c:\xampp\htdocs\Gretex Corporate main\css\Ipo\bcpl-railway-infrastructure-limited.css", "PostCSS", 0, 0, 30, 0, 0, 3, 33
"c:\xampp\htdocs\Gretex Corporate main\css\Ipo\bilwin-industries-limited.css", "PostCSS", 0, 0, 30, 0, 0, 3, 33
"c:\xampp\htdocs\Gretex Corporate main\css\Ipo\comrade-appliances-limited.css", "PostCSS", 0, 0, 30, 0, 0, 3, 33
"c:\xampp\htdocs\Gretex Corporate main\css\Ipo\deep-polymers-limited.css", "PostCSS", 0, 0, 30, 0, 0, 3, 33
"c:\xampp\htdocs\Gretex Corporate main\css\Ipo\dhruv-wellness-limited.css", "PostCSS", 0, 0, 30, 0, 0, 3, 33
"c:\xampp\htdocs\Gretex Corporate main\css\Ipo\diggi-multitrade-limited.css", "PostCSS", 0, 0, 30, 0, 0, 3, 33
"c:\xampp\htdocs\Gretex Corporate main\css\Ipo\flywings-simulator-training-center-limited.css", "PostCSS", 0, 0, 30, 0, 0, 3, 33
"c:\xampp\htdocs\Gretex Corporate main\css\Ipo\g-m-polyplast-limited.css", "PostCSS", 0, 0, 30, 0, 0, 3, 33
"c:\xampp\htdocs\Gretex Corporate main\css\Ipo\gnh-india-pharmaceuticals-limited.css", "PostCSS", 0, 0, 30, 0, 0, 3, 33
"c:\xampp\htdocs\Gretex Corporate main\css\Ipo\goel-food-products-limited.css", "PostCSS", 0, 0, 30, 0, 0, 3, 33
"c:\xampp\htdocs\Gretex Corporate main\css\Ipo\innokiaz-india-limited.css", "PostCSS", 0, 0, 30, 0, 0, 3, 33
"c:\xampp\htdocs\Gretex Corporate main\css\Ipo\interiors-and-more-limited.css", "PostCSS", 0, 0, 30, 0, 0, 3, 33
"c:\xampp\htdocs\Gretex Corporate main\css\Ipo\ipo-global.css", "PostCSS", 0, 0, 129, 0, 0, 16, 145
"c:\xampp\htdocs\Gretex Corporate main\css\Ipo\ipo.css", "PostCSS", 0, 0, 824, 0, 6, 150, 980
"c:\xampp\htdocs\Gretex Corporate main\css\Ipo\jash-dealmark-limited.css", "PostCSS", 0, 0, 30, 0, 0, 3, 33
"c:\xampp\htdocs\Gretex Corporate main\css\Ipo\jayant-infratech-limited.css", "PostCSS", 0, 0, 30, 0, 0, 3, 33
"c:\xampp\htdocs\Gretex Corporate main\css\Ipo\kalyani-cast-tech-limited.css", "PostCSS", 0, 0, 30, 0, 0, 3, 33
"c:\xampp\htdocs\Gretex Corporate main\css\Ipo\kids-medical-system-limited.css", "PostCSS", 0, 0, 30, 0, 0, 3, 33
"c:\xampp\htdocs\Gretex Corporate main\css\Ipo\mac-hotels-limited.css", "PostCSS", 0, 0, 30, 0, 0, 3, 33
"c:\xampp\htdocs\Gretex Corporate main\css\Ipo\markolines-traffic-controls-limited.css", "PostCSS", 0, 0, 30, 0, 0, 3, 33
"c:\xampp\htdocs\Gretex Corporate main\css\Ipo\misquita-engineering-limited.css", "PostCSS", 0, 0, 30, 0, 0, 3, 33
"c:\xampp\htdocs\Gretex Corporate main\css\Ipo\moving-media-entertainment-limited.css", "PostCSS", 0, 0, 30, 0, 0, 3, 33
"c:\xampp\htdocs\Gretex Corporate main\css\Ipo\niks-technology-limited.css", "PostCSS", 0, 0, 30, 0, 0, 3, 33
"c:\xampp\htdocs\Gretex Corporate main\css\Ipo\oan-industries-limited.css", "PostCSS", 0, 0, 30, 0, 0, 3, 33
"c:\xampp\htdocs\Gretex Corporate main\css\Ipo\omviras-marine-services-limited.css", "PostCSS", 0, 0, 30, 0, 0, 3, 33
"c:\xampp\htdocs\Gretex Corporate main\css\Ipo\owais-metal-and-mineral-processing-limited.css", "PostCSS", 0, 0, 30, 0, 0, 3, 33
"c:\xampp\htdocs\Gretex Corporate main\css\Ipo\paramount-dye-tec-limited.css", "PostCSS", 0, 0, 30, 0, 0, 3, 33
"c:\xampp\htdocs\Gretex Corporate main\css\Ipo\platinumone-business-services-limited.css", "PostCSS", 0, 0, 30, 0, 0, 3, 33
"c:\xampp\htdocs\Gretex Corporate main\css\Ipo\rapid-multimodal-logistics-limited.css", "PostCSS", 0, 0, 33, 0, 0, 7, 40
"c:\xampp\htdocs\Gretex Corporate main\css\Ipo\resgen-limited.css", "PostCSS", 0, 0, 37, 0, 0, 6, 43
"c:\xampp\htdocs\Gretex Corporate main\css\Ipo\retaggio-industries-limited.css", "PostCSS", 0, 0, 37, 0, 0, 5, 42
"c:\xampp\htdocs\Gretex Corporate main\css\Ipo\retina-paints-limited.css", "PostCSS", 0, 0, 37, 0, 0, 5, 42
"c:\xampp\htdocs\Gretex Corporate main\css\Ipo\riddhi-corporate-services-limited copy.css", "PostCSS", 0, 0, 37, 0, 0, 5, 42
"c:\xampp\htdocs\Gretex Corporate main\css\Ipo\sagar-diamonds-limited.css", "PostCSS", 0, 0, 37, 0, 0, 5, 42
"c:\xampp\htdocs\Gretex Corporate main\css\Ipo\salini-tours-n-travels-limited.css", "PostCSS", 0, 0, 30, 0, 0, 3, 33
"c:\xampp\htdocs\Gretex Corporate main\css\Ipo\sellowrap-industries-limited.css", "PostCSS", 0, 0, 30, 0, 0, 3, 33
"c:\xampp\htdocs\Gretex Corporate main\css\Ipo\shelter-pharma-limited.css", "PostCSS", 0, 0, 30, 0, 0, 3, 33
"c:\xampp\htdocs\Gretex Corporate main\css\Ipo\shreyas-fabtech-limited.css", "PostCSS", 0, 0, 30, 0, 0, 3, 33
"c:\xampp\htdocs\Gretex Corporate main\css\Ipo\siddharth-education-services-limited.css", "PostCSS", 0, 0, 30, 0, 0, 3, 33
"c:\xampp\htdocs\Gretex Corporate main\css\Ipo\silky-overseas-limited.css", "PostCSS", 0, 0, 30, 0, 0, 3, 33
"c:\xampp\htdocs\Gretex Corporate main\css\Ipo\ssg-furnishing-solution-limited.css", "PostCSS", 0, 0, 30, 0, 0, 3, 33
"c:\xampp\htdocs\Gretex Corporate main\css\Ipo\steelman-telecom-limited.css", "PostCSS", 0, 0, 30, 0, 0, 3, 33
"c:\xampp\htdocs\Gretex Corporate main\css\Ipo\subam-papers-limited.css", "PostCSS", 0, 0, 30, 0, 0, 3, 33
"c:\xampp\htdocs\Gretex Corporate main\css\Ipo\sudarshan-pharma-industries-limited.css", "PostCSS", 0, 0, 30, 0, 0, 3, 33
"c:\xampp\htdocs\Gretex Corporate main\css\Ipo\suumaya-lifestyle-limited.css", "PostCSS", 0, 0, 30, 0, 0, 3, 33
"c:\xampp\htdocs\Gretex Corporate main\css\Ipo\tenty-limited.css", "PostCSS", 0, 0, 30, 0, 0, 3, 33
"c:\xampp\htdocs\Gretex Corporate main\css\Ipo\trackpoint-gps-limited.css", "PostCSS", 0, 0, 30, 0, 0, 3, 33
"c:\xampp\htdocs\Gretex Corporate main\css\Ipo\transteel-seating-technologies-limited.css", "PostCSS", 0, 0, 30, 0, 0, 3, 33
"c:\xampp\htdocs\Gretex Corporate main\css\Ipo\veeram-ornaments-limited.css", "PostCSS", 0, 0, 30, 0, 0, 3, 33
"c:\xampp\htdocs\Gretex Corporate main\css\Ipo\yug-decor-limited.css", "PostCSS", 0, 0, 30, 0, 0, 3, 33
"c:\xampp\htdocs\Gretex Corporate main\css\Ipo\zenith-drugs-limited.css", "PostCSS", 0, 0, 30, 0, 0, 3, 33
"c:\xampp\htdocs\Gretex Corporate main\css\about\about.css", "PostCSS", 0, 0, 1055, 0, 14, 198, 1267
"c:\xampp\htdocs\Gretex Corporate main\css\blog\blog-template.css", "PostCSS", 0, 0, 367, 0, 0, 57, 424
"c:\xampp\htdocs\Gretex Corporate main\css\blog\blog.css", "PostCSS", 0, 0, 310, 0, 0, 42, 352
"c:\xampp\htdocs\Gretex Corporate main\css\careers\careers.css", "PostCSS", 0, 0, 1193, 0, 8, 214, 1415
"c:\xampp\htdocs\Gretex Corporate main\css\careers\catalyst-connect.css", "PostCSS", 0, 0, 638, 0, 4, 160, 802
"c:\xampp\htdocs\Gretex Corporate main\css\careers\job.css", "PostCSS", 0, 0, 263, 0, 0, 35, 298
"c:\xampp\htdocs\Gretex Corporate main\css\contact.css", "PostCSS", 0, 0, 489, 0, 1, 111, 601
"c:\xampp\htdocs\Gretex Corporate main\css\csr\csr.css", "PostCSS", 0, 0, 782, 0, 6, 133, 921
"c:\xampp\htdocs\Gretex Corporate main\css\global copy 2.css", "PostCSS", 0, 0, 853, 0, 365, 199, 1417
"c:\xampp\htdocs\Gretex Corporate main\css\global copy 3.css", "PostCSS", 0, 0, 793, 0, 35, 153, 981
"c:\xampp\htdocs\Gretex Corporate main\css\global copy.css", "PostCSS", 0, 0, 280, 0, 12, 45, 337
"c:\xampp\htdocs\Gretex Corporate main\css\global.css", "PostCSS", 0, 0, 974, 0, 54, 204, 1232
"c:\xampp\htdocs\Gretex Corporate main\css\index copy.css", "PostCSS", 0, 0, 1038, 0, 17, 218, 1273
"c:\xampp\htdocs\Gretex Corporate main\css\index.css", "PostCSS", 0, 0, 1428, 0, 10, 239, 1677
"c:\xampp\htdocs\Gretex Corporate main\css\investor-relations\announcements.css", "PostCSS", 0, 0, 171, 0, 4, 32, 207
"c:\xampp\htdocs\Gretex Corporate main\css\investor-relations\annual-reports.css", "PostCSS", 0, 0, 168, 0, 0, 22, 190
"c:\xampp\htdocs\Gretex Corporate main\css\investor-relations\business-details.css", "PostCSS", 0, 0, 116, 0, 0, 15, 131
"c:\xampp\htdocs\Gretex Corporate main\css\investor-relations\codes-and-policies.css", "PostCSS", 0, 0, 9, 0, 0, 3, 12
"c:\xampp\htdocs\Gretex Corporate main\css\investor-relations\compliance-with-stock-exchange.css", "PostCSS", 0, 0, 180, 0, 4, 31, 215
"c:\xampp\htdocs\Gretex Corporate main\css\investor-relations\composition-of-board-of-directors.css", "PostCSS", 0, 0, 550, 0, 1, 93, 644
"c:\xampp\htdocs\Gretex Corporate main\css\investor-relations\gretex-rights-issue.css", "PostCSS", 0, 0, 8, 0, 0, 1, 9
"c:\xampp\htdocs\Gretex Corporate main\css\investor-relations\investor-charter.css", "PostCSS", 0, 0, 9, 0, 0, 3, 12
"c:\xampp\htdocs\Gretex Corporate main\css\investor-relations\investor-complaints.css", "PostCSS", 0, 0, 163, 0, 0, 34, 197
"c:\xampp\htdocs\Gretex Corporate main\css\investor-relations\investor-contact.css", "PostCSS", 0, 0, 8, 0, 0, 1, 9
"c:\xampp\htdocs\Gretex Corporate main\css\investor-relations\investor-relations-main-template.css", "PostCSS", 0, 0, 154, 0, 0, 21, 175
"c:\xampp\htdocs\Gretex Corporate main\css\investor-relations\investor-relations.css", "PostCSS", 0, 0, 747, 0, 21, 145, 913
"c:\xampp\htdocs\Gretex Corporate main\css\investor-relations\memorandum-of-association-and-articles-of-association.css", "PostCSS", 0, 0, 103, 0, 1, 18, 122
"c:\xampp\htdocs\Gretex Corporate main\css\investor-relations\notice-for-shareholders.css", "PostCSS", 0, 0, 104, 0, 1, 19, 124
"c:\xampp\htdocs\Gretex Corporate main\css\investor-relations\scrutinizer-report.css", "PostCSS", 0, 0, 8, 0, 0, 1, 9
"c:\xampp\htdocs\Gretex Corporate main\css\investor-relations\shareholding-pattern.css", "PostCSS", 0, 0, 104, 0, 1, 19, 124
"c:\xampp\htdocs\Gretex Corporate main\css\investor-relations\statement-of-deviation.css", "PostCSS", 0, 0, 8, 0, 0, 1, 9
"c:\xampp\htdocs\Gretex Corporate main\css\investor-relations\terms-and-conditions-for-appointment-of-independent-director.css", "PostCSS", 0, 0, 8, 0, 0, 1, 9
"c:\xampp\htdocs\Gretex Corporate main\css\legal\privacy-policy.css", "PostCSS", 0, 0, 112, 0, 0, 12, 124
"c:\xampp\htdocs\Gretex Corporate main\css\offer-documents\open-offer-template-main\open-offer-template.css", "PostCSS", 0, 0, 237, 0, 2, 38, 277
"c:\xampp\htdocs\Gretex Corporate main\css\offer-documents\open-offer\anshuni-commercials-limited.css", "PostCSS", 0, 0, 16, 0, 0, 1, 17
"c:\xampp\htdocs\Gretex Corporate main\css\offer-documents\open-offer\deepti-alloy-steel-limited.css", "PostCSS", 0, 0, 16, 0, 0, 1, 17
"c:\xampp\htdocs\Gretex Corporate main\css\offer-documents\open-offer\econo-trade-india-limited.css", "PostCSS", 0, 0, 16, 0, 0, 1, 17
"c:\xampp\htdocs\Gretex Corporate main\css\offer-documents\open-offer\kwality-credit-and-leasing-limited.css", "PostCSS", 0, 0, 16, 0, 0, 1, 17
"c:\xampp\htdocs\Gretex Corporate main\css\offer-documents\open-offer\neil-industries-limited.css", "PostCSS", 0, 0, 16, 0, 0, 1, 17
"c:\xampp\htdocs\Gretex Corporate main\css\offer-documents\open-offer\open-offer.css", "PostCSS", 0, 0, 735, 0, 7, 120, 862
"c:\xampp\htdocs\Gretex Corporate main\css\offer-documents\open-offer\ph-trading-limited.css", "PostCSS", 0, 0, 16, 0, 0, 1, 17
"c:\xampp\htdocs\Gretex Corporate main\css\offer-documents\open-offer\prozone-realty-limited.css", "PostCSS", 0, 0, 16, 0, 0, 2, 18
"c:\xampp\htdocs\Gretex Corporate main\css\offer-documents\open-offer\rcl-retails-limited.css", "PostCSS", 0, 0, 16, 0, 0, 1, 17
"c:\xampp\htdocs\Gretex Corporate main\css\offer-documents\open-offer\reliance-jute-international-mills-limited.css", "PostCSS", 0, 0, 16, 0, 0, 1, 17
"c:\xampp\htdocs\Gretex Corporate main\css\offer-documents\open-offer\sharad-fibres-&-yarn-processors-limited.css", "PostCSS", 0, 0, 16, 0, 0, 1, 17
"c:\xampp\htdocs\Gretex Corporate main\css\offer-documents\open-offer\stratmont-industries-limited.css", "PostCSS", 0, 0, 16, 0, 0, 1, 17
"c:\xampp\htdocs\Gretex Corporate main\css\offer-documents\open-offer\tirrihannah-company-limited.css", "PostCSS", 0, 0, 16, 0, 0, 1, 17
"c:\xampp\htdocs\Gretex Corporate main\css\what-we-do\capital-markets\capital-markets.css", "PostCSS", 0, 0, 406, 0, 1, 67, 474
"c:\xampp\htdocs\Gretex Corporate main\css\what-we-do\capital-markets\ipo.css", "PostCSS", 0, 0, 735, 0, 4, 144, 883
"c:\xampp\htdocs\Gretex Corporate main\css\what-we-do\service copy.css", "PostCSS", 0, 0, 556, 0, 4, 125, 685
"c:\xampp\htdocs\Gretex Corporate main\css\what-we-do\services copy.css", "PostCSS", 0, 0, 562, 0, 5, 101, 668
"c:\xampp\htdocs\Gretex Corporate main\css\what-we-do\what-we-do-main.css", "PostCSS", 0, 0, 690, 0, 7, 129, 826
"c:\xampp\htdocs\Gretex Corporate main\footer.php", "PHP", 119, 0, 0, 0, 0, 4, 123
"c:\xampp\htdocs\Gretex Corporate main\header copy 3.php", "PHP", 578, 0, 0, 0, 0, 59, 637
"c:\xampp\htdocs\Gretex Corporate main\header copy.php", "PHP", 80, 0, 0, 0, 0, 4, 84
"c:\xampp\htdocs\Gretex Corporate main\header.php", "PHP", 290, 0, 0, 0, 0, 23, 313
"c:\xampp\htdocs\Gretex Corporate main\helpers\urlfetcher.php", "PHP", 18, 0, 0, 0, 2, 4, 24
"c:\xampp\htdocs\Gretex Corporate main\index.php", "PHP", 653, 0, 0, 0, 19, 73, 745
"c:\xampp\htdocs\Gretex Corporate main\investor-relations\codes-and-policies.php", "PHP", 276, 0, 0, 0, 0, 15, 291
"c:\xampp\htdocs\Gretex Corporate main\investor-relations\disclosures-under-reg-46-of-lodr\announcements.php", "PHP", 1977, 0, 0, 0, 4, 65, 2046
"c:\xampp\htdocs\Gretex Corporate main\investor-relations\disclosures-under-reg-46-of-lodr\archival.php", "PHP", 104, 0, 0, 0, 0, 15, 119
"c:\xampp\htdocs\Gretex Corporate main\investor-relations\disclosures-under-reg-46-of-lodr\business-details.php", "PHP", 63, 0, 0, 0, 0, 16, 79
"c:\xampp\htdocs\Gretex Corporate main\investor-relations\disclosures-under-reg-46-of-lodr\compliance-with-stock-exchange.php", "PHP", 549, 0, 0, 0, 4, 35, 588
"c:\xampp\htdocs\Gretex Corporate main\investor-relations\disclosures-under-reg-46-of-lodr\composition-of-board-of-directors.php", "PHP", 288, 0, 0, 0, 0, 29, 317
"c:\xampp\htdocs\Gretex Corporate main\investor-relations\disclosures-under-reg-46-of-lodr\financial-information\annual-reports.php", "PHP", 219, 0, 0, 0, 0, 16, 235
"c:\xampp\htdocs\Gretex Corporate main\investor-relations\disclosures-under-reg-46-of-lodr\financial-information\annual-returns.php", "PHP", 143, 0, 0, 0, 0, 16, 159
"c:\xampp\htdocs\Gretex Corporate main\investor-relations\disclosures-under-reg-46-of-lodr\financial-information\financial-results.php", "PHP", 219, 0, 0, 0, 0, 14, 233
"c:\xampp\htdocs\Gretex Corporate main\investor-relations\disclosures-under-reg-46-of-lodr\financial-information\financials-subsidiary.php", "PHP", 105, 0, 0, 0, 0, 15, 120
"c:\xampp\htdocs\Gretex Corporate main\investor-relations\disclosures-under-reg-46-of-lodr\financial-information\index.php", "PHP", 0, 0, 0, 0, 0, 1, 1
"c:\xampp\htdocs\Gretex Corporate main\investor-relations\disclosures-under-reg-46-of-lodr\index.php", "PHP", 37, 0, 0, 0, 0, 14, 51
"c:\xampp\htdocs\Gretex Corporate main\investor-relations\disclosures-under-reg-46-of-lodr\investor-contact.php", "PHP", 87, 0, 0, 0, 0, 15, 102
"c:\xampp\htdocs\Gretex Corporate main\investor-relations\disclosures-under-reg-46-of-lodr\memorandum-of-association-and-articles-of-association.php", "PHP", 88, 0, 0, 0, 0, 13, 101
"c:\xampp\htdocs\Gretex Corporate main\investor-relations\disclosures-under-reg-46-of-lodr\notice-for-shareholders.php", "PHP", 218, 0, 0, 0, 0, 15, 233
"c:\xampp\htdocs\Gretex Corporate main\investor-relations\disclosures-under-reg-46-of-lodr\scrutinizer-report.php", "PHP", 106, 0, 0, 0, 0, 16, 122
"c:\xampp\htdocs\Gretex Corporate main\investor-relations\disclosures-under-reg-46-of-lodr\shareholding-pattern.php", "PHP", 201, 0, 0, 0, 0, 16, 217
"c:\xampp\htdocs\Gretex Corporate main\investor-relations\disclosures-under-reg-46-of-lodr\statement-of-deviation.php", "PHP", 87, 0, 0, 0, 0, 15, 102
"c:\xampp\htdocs\Gretex Corporate main\investor-relations\disclosures-under-reg-46-of-lodr\terms-and-condition-for-appointment-of-independent-director.php", "PHP", 87, 0, 0, 0, 0, 13, 100
"c:\xampp\htdocs\Gretex Corporate main\investor-relations\gretex-rights-issue.php", "PHP", 123, 0, 0, 0, 0, 13, 136
"c:\xampp\htdocs\Gretex Corporate main\investor-relations\index.php", "PHP", 430, 0, 0, 0, 2, 53, 485
"c:\xampp\htdocs\Gretex Corporate main\investor-relations\investor-charter.php", "PHP", 256, 0, 0, 0, 0, 13, 269
"c:\xampp\htdocs\Gretex Corporate main\investor-relations\investor-complaints.php", "PHP", 871, 0, 0, 0, 0, 23, 894
"c:\xampp\htdocs\Gretex Corporate main\js\about-page-animations.js", "JavaScript", 0, 0, 0, 3, 0, 2, 5
"c:\xampp\htdocs\Gretex Corporate main\js\global-animations.js", "JavaScript", 0, 0, 0, 0, 0, 1, 1
"c:\xampp\htdocs\Gretex Corporate main\js\mobilemenu.js", "JavaScript", 0, 0, 0, 19, 1, 3, 23
"c:\xampp\htdocs\Gretex Corporate main\js\script.js", "JavaScript", 0, 0, 0, 0, 0, 1, 1
"c:\xampp\htdocs\Gretex Corporate main\legal\privacy-policy.php", "PHP", 45, 0, 0, 0, 0, 13, 58
"c:\xampp\htdocs\Gretex Corporate main\offer-documents\ipo\a-m-febcon-limited\index.php", "PHP", 119, 0, 0, 0, 0, 18, 137
"c:\xampp\htdocs\Gretex Corporate main\offer-documents\ipo\aaron-industries-limited\index.php", "PHP", 117, 0, 0, 0, 0, 15, 132
"c:\xampp\htdocs\Gretex Corporate main\offer-documents\ipo\aki-india-limited\index.php", "PHP", 77, 0, 0, 0, 0, 13, 90
"c:\xampp\htdocs\Gretex Corporate main\offer-documents\ipo\akme-fintrade-india-limited\index.php", "PHP", 79, 0, 0, 0, 0, 13, 92
"c:\xampp\htdocs\Gretex Corporate main\offer-documents\ipo\amic-forging-limited\index.php", "PHP", 116, 0, 0, 0, 0, 14, 130
"c:\xampp\htdocs\Gretex Corporate main\offer-documents\ipo\anuroop-packaging-limited\index.php", "PHP", 136, 0, 0, 0, 0, 13, 149
"c:\xampp\htdocs\Gretex Corporate main\offer-documents\ipo\arc-insulation-&-insulators-limited\index.php", "PHP", 79, 0, 0, 0, 0, 13, 92
"c:\xampp\htdocs\Gretex Corporate main\offer-documents\ipo\associated-coaters-limited\index.php", "PHP", 96, 0, 0, 0, 0, 13, 109
"c:\xampp\htdocs\Gretex Corporate main\offer-documents\ipo\b&b-triplewall-containers-limited\index.php", "PHP", 139, 0, 0, 0, 0, 14, 153
"c:\xampp\htdocs\Gretex Corporate main\offer-documents\ipo\b-right-realestate-limited\index.php", "PHP", 136, 0, 0, 0, 0, 13, 149
"c:\xampp\htdocs\Gretex Corporate main\offer-documents\ipo\bcpl-railway-infrastructure-limited\index.php", "PHP", 117, 0, 0, 0, 0, 13, 130
"c:\xampp\htdocs\Gretex Corporate main\offer-documents\ipo\bilwin-industries-limited\index.php", "PHP", 135, 0, 0, 0, 0, 14, 149
"c:\xampp\htdocs\Gretex Corporate main\offer-documents\ipo\clara-industries-limited\index.php", "PHP", 138, 0, 0, 0, 0, 14, 152
"c:\xampp\htdocs\Gretex Corporate main\offer-documents\ipo\comrade-appliances-limited\index.php", "PHP", 136, 0, 0, 0, 0, 14, 150
"c:\xampp\htdocs\Gretex Corporate main\offer-documents\ipo\debock-sales-&-marketing-limited\index.php", "PHP", 138, 0, 0, 0, 0, 13, 151
"c:\xampp\htdocs\Gretex Corporate main\offer-documents\ipo\deep-polymers-limited\index.php", "PHP", 135, 0, 0, 0, 0, 14, 149
"c:\xampp\htdocs\Gretex Corporate main\offer-documents\ipo\dhruv-wellness-limited\index.php", "PHP", 119, 0, 0, 0, 0, 15, 134
"c:\xampp\htdocs\Gretex Corporate main\offer-documents\ipo\diggi-multitrade-limited\index.php", "PHP", 100, 0, 0, 0, 0, 14, 114
"c:\xampp\htdocs\Gretex Corporate main\offer-documents\ipo\flywings-simulator-training-center-limited\index.php", "PHP", 79, 0, 0, 0, 0, 12, 91
"c:\xampp\htdocs\Gretex Corporate main\offer-documents\ipo\g-m-polyplast-limited\index.php", "PHP", 119, 0, 0, 0, 0, 12, 131
"c:\xampp\htdocs\Gretex Corporate main\offer-documents\ipo\gnh-india-pharmaceuticals-limited\index.php", "PHP", 81, 0, 0, 0, 0, 14, 95
"c:\xampp\htdocs\Gretex Corporate main\offer-documents\ipo\goel-food-products-limited\index.php", "PHP", 140, 0, 0, 0, 0, 15, 155
"c:\xampp\htdocs\Gretex Corporate main\offer-documents\ipo\index.php", "PHP", 1513, 0, 0, 0, 4, 158, 1675
"c:\xampp\htdocs\Gretex Corporate main\offer-documents\ipo\innokaiz-india-limited\index.php", "PHP", 139, 0, 0, 0, 0, 15, 154
"c:\xampp\htdocs\Gretex Corporate main\offer-documents\ipo\interiors-and-more-limited\index.php", "PHP", 140, 0, 0, 0, 0, 13, 153
"c:\xampp\htdocs\Gretex Corporate main\offer-documents\ipo\jash-dealmark-limited\index.php", "PHP", 139, 0, 0, 0, 0, 17, 156
"c:\xampp\htdocs\Gretex Corporate main\offer-documents\ipo\jayant-infratech-limited\index.php", "PHP", 140, 0, 0, 0, 0, 11, 151
"c:\xampp\htdocs\Gretex Corporate main\offer-documents\ipo\kalyani-cast-tech-limited\index.php", "PHP", 160, 0, 0, 0, 0, 13, 173
"c:\xampp\htdocs\Gretex Corporate main\offer-documents\ipo\kids-medical-system-limited\index.php", "PHP", 160, 0, 0, 0, 0, 13, 173
"c:\xampp\htdocs\Gretex Corporate main\offer-documents\ipo\mac-hotels-limited\index.php", "PHP", 143, 0, 0, 0, 0, 13, 156
"c:\xampp\htdocs\Gretex Corporate main\offer-documents\ipo\markolines-traffic-controls-limited\index.php", "PHP", 144, 0, 0, 0, 0, 12, 156
"c:\xampp\htdocs\Gretex Corporate main\offer-documents\ipo\misquita-engineering-limited\index.php", "PHP", 138, 0, 0, 0, 0, 13, 151
"c:\xampp\htdocs\Gretex Corporate main\offer-documents\ipo\moving-media-entertainment-limited\index.php", "PHP", 80, 0, 0, 0, 0, 13, 93
"c:\xampp\htdocs\Gretex Corporate main\offer-documents\ipo\mpk-steels-1-limited\index.php", "PHP", 139, 0, 0, 0, 0, 14, 153
"c:\xampp\htdocs\Gretex Corporate main\offer-documents\ipo\niks-technology-limited\index.php", "PHP", 118, 0, 0, 0, 0, 12, 130
"c:\xampp\htdocs\Gretex Corporate main\offer-documents\ipo\oan-industries-limited\index.php", "PHP", 79, 0, 0, 0, 0, 12, 91
"c:\xampp\htdocs\Gretex Corporate main\offer-documents\ipo\omviras-marine-services-limited\index.php", "PHP", 58, 0, 0, 0, 0, 14, 72
"c:\xampp\htdocs\Gretex Corporate main\offer-documents\ipo\owais-metal-and-mineral-processing-limited\index.php", "PHP", 160, 0, 0, 0, 0, 12, 172
"c:\xampp\htdocs\Gretex Corporate main\offer-documents\ipo\paramount-dye-tec-limited\index.php", "PHP", 120, 0, 0, 0, 0, 12, 132
"c:\xampp\htdocs\Gretex Corporate main\offer-documents\ipo\platinumone-business-services-limited\index.php", "PHP", 140, 0, 0, 0, 0, 12, 152
"c:\xampp\htdocs\Gretex Corporate main\offer-documents\ipo\rapid-fleet-management-services-limited\index.php", "PHP", 82, 0, 0, 0, 0, 12, 94
"c:\xampp\htdocs\Gretex Corporate main\offer-documents\ipo\rapid-multimodal-logistics-limited\index.php", "PHP", 160, 0, 0, 0, 0, 12, 172
"c:\xampp\htdocs\Gretex Corporate main\offer-documents\ipo\reetech-international-cargo-courier-limited\index.php", "PHP", 142, 0, 0, 0, 0, 14, 156
"c:\xampp\htdocs\Gretex Corporate main\offer-documents\ipo\resgen-limited\index.php", "PHP", 184, 0, 0, 0, 0, 12, 196
"c:\xampp\htdocs\Gretex Corporate main\offer-documents\ipo\retaggio-industries-limited\index.php", "PHP", 76, 0, 0, 0, 0, 14, 90
"c:\xampp\htdocs\Gretex Corporate main\offer-documents\ipo\retina-paints-limited\index.php", "PHP", 139, 0, 0, 0, 0, 13, 152
"c:\xampp\htdocs\Gretex Corporate main\offer-documents\ipo\riddhi-corporate-services-limited\index.php", "PHP", 120, 0, 0, 0, 0, 14, 134
"c:\xampp\htdocs\Gretex Corporate main\offer-documents\ipo\sagar-diamonds-limited\index.php", "PHP", 119, 0, 0, 0, 0, 13, 132
"c:\xampp\htdocs\Gretex Corporate main\offer-documents\ipo\sailani-tours-n-travels-limited\index.php", "PHP", 143, 0, 0, 0, 0, 12, 155
"c:\xampp\htdocs\Gretex Corporate main\offer-documents\ipo\sellowrap-industries-limited\index.php", "PHP", 60, 0, 0, 0, 0, 14, 74
"c:\xampp\htdocs\Gretex Corporate main\offer-documents\ipo\shelter-pharma-limited\index.php", "PHP", 159, 0, 0, 0, 0, 13, 172
"c:\xampp\htdocs\Gretex Corporate main\offer-documents\ipo\shreyas-fabtech-limited\index.php", "PHP", 79, 0, 0, 0, 0, 15, 94
"c:\xampp\htdocs\Gretex Corporate main\offer-documents\ipo\siddharth-education-services-limited\index.php", "PHP", 163, 0, 0, 0, 0, 15, 178
"c:\xampp\htdocs\Gretex Corporate main\offer-documents\ipo\silky-overseas-limited\index.php", "PHP", 79, 0, 0, 0, 0, 14, 93
"c:\xampp\htdocs\Gretex Corporate main\offer-documents\ipo\ssg-furnishing-solution-limited\index.php", "PHP", 60, 0, 0, 0, 0, 15, 75
"c:\xampp\htdocs\Gretex Corporate main\offer-documents\ipo\steelman-telecom-limited\index.php", "PHP", 140, 0, 0, 0, 0, 13, 153
"c:\xampp\htdocs\Gretex Corporate main\offer-documents\ipo\subam-papers-limited\index.php", "PHP", 119, 0, 0, 0, 0, 14, 133
"c:\xampp\htdocs\Gretex Corporate main\offer-documents\ipo\sudarshan-pharma-industries-limited\index.php", "PHP", 160, 0, 0, 0, 0, 13, 173
"c:\xampp\htdocs\Gretex Corporate main\offer-documents\ipo\suumaya-lifestyle-limited\index.php", "PHP", 120, 0, 0, 0, 0, 13, 133
"c:\xampp\htdocs\Gretex Corporate main\offer-documents\ipo\tenty-limited\index.php", "PHP", 79, 0, 0, 0, 0, 13, 92
"c:\xampp\htdocs\Gretex Corporate main\offer-documents\ipo\trackpoint-gps-limited\index.php", "PHP", 79, 0, 0, 0, 0, 13, 92
"c:\xampp\htdocs\Gretex Corporate main\offer-documents\ipo\transteel-seating-technologies-limited\index.php", "PHP", 140, 0, 0, 0, 0, 13, 153
"c:\xampp\htdocs\Gretex Corporate main\offer-documents\ipo\veeram-ornaments-limited\index.php", "PHP", 120, 0, 0, 0, 0, 15, 135
"c:\xampp\htdocs\Gretex Corporate main\offer-documents\ipo\yug-decor-limited\index.php", "PHP", 139, 0, 0, 0, 0, 15, 154
"c:\xampp\htdocs\Gretex Corporate main\offer-documents\ipo\zenith-drugs-limited\index.php", "PHP", 139, 0, 0, 0, 0, 14, 153
"c:\xampp\htdocs\Gretex Corporate main\offer-documents\open-offer\anshuni-commercials-limited\index.php", "PHP", 143, 0, 0, 0, 0, 14, 157
"c:\xampp\htdocs\Gretex Corporate main\offer-documents\open-offer\deepti-alloy-steel-limited\index.php", "PHP", 226, 0, 0, 0, 0, 15, 241
"c:\xampp\htdocs\Gretex Corporate main\offer-documents\open-offer\econo-trade-india-limited\index.php", "PHP", 243, 0, 0, 0, 0, 15, 258
"c:\xampp\htdocs\Gretex Corporate main\offer-documents\open-offer\index.php", "PHP", 948, 0, 0, 0, 2, 64, 1014
"c:\xampp\htdocs\Gretex Corporate main\offer-documents\open-offer\kwality-credit-and-leasing-limited\index.php", "PHP", 186, 0, 0, 0, 0, 15, 201
"c:\xampp\htdocs\Gretex Corporate main\offer-documents\open-offer\neil-industries-limited\index.php", "PHP", 203, 0, 0, 0, 0, 14, 217
"c:\xampp\htdocs\Gretex Corporate main\offer-documents\open-offer\ph-trading-limited\index.php", "PHP", 163, 0, 0, 0, 0, 14, 177
"c:\xampp\htdocs\Gretex Corporate main\offer-documents\open-offer\prozone-realty-limited\index.php", "PHP", 163, 0, 0, 0, 0, 14, 177
"c:\xampp\htdocs\Gretex Corporate main\offer-documents\open-offer\rcl-retails-limited\index.php", "PHP", 223, 0, 0, 0, 0, 14, 237
"c:\xampp\htdocs\Gretex Corporate main\offer-documents\open-offer\reliance-jute-international-mills-limited\index.php", "PHP", 203, 0, 0, 0, 0, 14, 217
"c:\xampp\htdocs\Gretex Corporate main\offer-documents\open-offer\sharad-fibres-&-yarn-processors-limited\index.php", "PHP", 203, 0, 0, 0, 0, 14, 217
"c:\xampp\htdocs\Gretex Corporate main\offer-documents\open-offer\stratmont-industries-limited\index.php", "PHP", 240, 0, 0, 0, 0, 14, 254
"c:\xampp\htdocs\Gretex Corporate main\offer-documents\open-offer\tirrihannah-company-limited\index.php", "PHP", 223, 0, 0, 0, 0, 14, 237
"c:\xampp\htdocs\Gretex Corporate main\random.html", "HTML", 0, 211, 0, 0, 33, 20, 264
"c:\xampp\htdocs\Gretex Corporate main\testimonials\index.php", "PHP", 0, 0, 0, 0, 0, 1, 1
"c:\xampp\htdocs\Gretex Corporate main\what-we-do\capital-markets\de-listing.php", "PHP", 967, 0, 0, 0, 2, 31, 1000
"c:\xampp\htdocs\Gretex Corporate main\what-we-do\capital-markets\exit-offer.php", "PHP", 967, 0, 0, 0, 2, 31, 1000
"c:\xampp\htdocs\Gretex Corporate main\what-we-do\capital-markets\fpo.php", "PHP", 967, 0, 0, 0, 2, 31, 1000
"c:\xampp\htdocs\Gretex Corporate main\what-we-do\capital-markets\index.php", "PHP", 375, 0, 0, 0, 12, 42, 429
"c:\xampp\htdocs\Gretex Corporate main\what-we-do\capital-markets\ipo.php", "PHP", 990, 0, 0, 0, 2, 32, 1024
"c:\xampp\htdocs\Gretex Corporate main\what-we-do\capital-markets\open-offer.php", "PHP", 967, 0, 0, 0, 2, 31, 1000
"c:\xampp\htdocs\Gretex Corporate main\what-we-do\capital-markets\rights-issue.php", "PHP", 967, 0, 0, 0, 2, 31, 1000
"c:\xampp\htdocs\Gretex Corporate main\what-we-do\compliance-advisory\index.php", "PHP", 341, 0, 0, 0, 12, 42, 395
"c:\xampp\htdocs\Gretex Corporate main\what-we-do\corporate-finance\bank-finance-and-issue-of-debt-securities.php", "PHP", 967, 0, 0, 0, 2, 31, 1000
"c:\xampp\htdocs\Gretex Corporate main\what-we-do\corporate-finance\index.php", "PHP", 429, 0, 0, 0, 6, 35, 470
"c:\xampp\htdocs\Gretex Corporate main\what-we-do\corporate-finance\private-equity.php", "PHP", 967, 0, 0, 0, 2, 31, 1000
"c:\xampp\htdocs\Gretex Corporate main\what-we-do\corporate-finance\valuation.php", "PHP", 967, 0, 0, 0, 2, 31, 1000
"c:\xampp\htdocs\Gretex Corporate main\what-we-do\corporate-finance\venture-capital.php", "PHP", 967, 0, 0, 0, 2, 31, 1000
"c:\xampp\htdocs\Gretex Corporate main\what-we-do\corporate-restructuring\demergers.php", "PHP", 967, 0, 0, 0, 2, 31, 1000
"c:\xampp\htdocs\Gretex Corporate main\what-we-do\corporate-restructuring\index.php", "PHP", 429, 0, 0, 0, 6, 35, 470
"c:\xampp\htdocs\Gretex Corporate main\what-we-do\corporate-restructuring\mergers-and-acquisitions.php", "PHP", 967, 0, 0, 0, 2, 31, 1000
"c:\xampp\htdocs\Gretex Corporate main\what-we-do\corporate-restructuring\takeover.php", "PHP", 967, 0, 0, 0, 2, 31, 1000
"c:\xampp\htdocs\Gretex Corporate main\what-we-do\index copy.php", "PHP", 119, 0, 0, 0, 0, 16, 135
"c:\xampp\htdocs\Gretex Corporate main\what-we-do\index.php", "PHP", 471, 0, 0, 0, 6, 24, 501
"c:\xampp\htdocs\Gretex Corporate main\what-we-do\service copy.php", "PHP", 942, 0, 0, 0, 2, 38, 982
"Total", "-", 39995, 211, 20007, 22, 785, 6524, 67544